often — часто
rather — скорее
ever — когда-либо
once — однажды
thus — таким образом
soon — вскоре
today — сегодня
perhaps — возможно
probably — вероятно
already — уже
however — однако
really — на самом деле
together — вместе
quite — вполне
sometimes — иногда
therefore — следовательно
else — еще (в добавок)
outside — снаружи
besides — кроме того
beyond — вдали
indeed — в самом деле
inside — внутри
ago — тому назад
how — как
so — таким образом
then — тогда
there — там
no — нет
now — сейчас
just — только что
very — очень
where — где
too — также
also — тоже
well — хорошо
again — опять
why — почему
here — здесь
still — все еще
off — вне
away — прочь
always — всегда
almost — почти
enough — достаточно
though — однако
never — никогда
since — с тех пор
round — вокруг
instead — вместо
likely — вероятно
especially — особенно
according — соответственно
below — ниже
without — вне
through — насквозь
throughout — повсюду
forward — вперед
forth — дальше
aside — в сторону
otherwise — иначе
seldom — редко
yesterday — вчера
tomorrow — завтра
moreover — кроме того
friendly — дружественно
somehow — как-нибудь
plenty — вдоволь
somewhere — где-то
apart — отдельно
beneath — внизу
everywhere — везде
anywise — каким-нибудь образом
when — когда
whenever — когда же
tonight — сегодня вечером
meanwhile — между тем
nowhere — нигде
altogether — полностью
yes — да
alike — одинаково
usually — обычно
occasionally — время от времени
rarely — редко
actually — на самом деле
easily — легко
hardly — едва
quickly — быстро
slowly — медленно
above — наверху
little — немного
much — гораздо
even — даже
before — раньше
lately — в последнее время
recently — недавно
almost — почти
as — как например
only — только